20
20
5 5 5 5 5 5 5 5 5 5 5 5 5 5 5 5 5 5 5 5 
5 0 0 0 0 0 0 0 0 0 0 0 0 0 0 0 0 0 0 5
5 0 0 0 0 0 0 0 0 0 0 0 0 0 0 0 0 0 0 5
5 0 0 0 5 5 5 5 0 0 0 0 0 0 0 0 0 0 0 5
5 0 0 0 0 0 0 0 0 0 0 5 0 0 0 0 0 0 0 5
5 0 0 0 0 0 0 0 0 0 5 5 5 0 0 0 0 0 0 5
5 0 0 0 0 0 0 0 0 0 0 0 0 0 0 0 0 0 0 5
5 0 0 0 0 5 0 0 0 5 0 0 0 0 0 0 0 0 0 5
5 0 0 0 0 5 0 0 0 5 0 0 0 0 0 0 0 0 0 5
5 0 0 0 0 5 0 0 0 5 5 0 0 0 0 0 0 0 0 5
5 0 0 0 0 5 0 0 0 0 0 5 0 0 0 0 0 0 0 5
5 0 0 0 0 5 5 5 5 0 0 0 0 0 0 5 0 0 0 5
5 0 0 0 0 0 0 0 0 0 0 0 0 5 5 5 0 0 0 5
5 0 0 0 0 0 0 0 0 0 0 0 0 0 5 0 0 0 0 5
5 0 1 0 0 13 13 0 0 7 0 0 5 5 0 0 0 0 0 5
5 0 0 0 0 0 7 0 0 0 5 5 5 0 0 0 0 0 0 5
5 0 14 9 9 5 5 5 0 0 0 0 0 0 0 0 0 0 0 5
5 0 0 0 0 0 0 0 0 0 5 5 5 5 0 0 8 0 0 5
5 0 0 0 0 0 0 0 0 5 5 5 5 5 5 0 0 0 0 5
5 5 5 5 5 5 5 5 5 5 5 5 5 5 5 5 5 5 5 5
