20
20
5 5 5 5 5 5 5 5 5 5 5 5 5 5 5 5 5 5 5 5 
5 0 0 0 0 0 0 0 0 0 0 0 0 0 0 0 0 0 0 5
5 0 0 0 0 0 0 0 0 0 0 0 0 0 0 0 0 0 0 5
5 0 0 0 5 5 5 5 0 0 0 0 0 0 0 0 0 0 0 5
5 0 0 0 0 0 0 0 0 0 0 5 0 0 0 0 0 0 0 5
5 0 0 0 0 0 0 0 0 0 5 5 5 0 0 0 0 0 0 5
5 0 0 0 0 0 0 0 0 0 0 0 0 0 0 0 0 0 0 5
5 0 0 0 0 5 0 0 0 5 0 0 0 0 0 0 0 0 0 5
5 0 0 0 0 5 0 0 0 5 0 0 0 0 0 0 0 0 0 5
5 0 0 0 0 5 0 0 0 5 5 0 0 0 0 0 0 0 0 5
5 0 0 0 0 5 0 0 0 0 0 5 0 0 0 0 0 0 0 5
5 0 0 0 0 5 5 5 5 0 0 0 0 3 0 5 0 0 0 5
5 0 0 0 0 0 0 0 0 0 0 0 0 5 5 5 0 0 0 5
5 0 0 0 0 0 3 0 0 0 0 0 0 0 5 0 0 0 0 5
5 0 1 0 0 14 14 0 0 7 0 0 5 5 0 0 0 0 0 5
5 0 0 0 0 0 7 0 0 0 5 5 5 0 0 0 0 0 0 5
5 0 14 10 10 5 5 5 0 0 0 0 0 0 0 0 0 0 0 5
5 0 0 0 0 0 0 0 0 0 5 5 5 5 0 0 9 0 0 5
5 0 0 0 0 0 0 0 0 5 5 5 5 5 5 0 0 0 0 5
5 5 5 5 5 5 5 5 5 5 5 5 5 5 5 5 5 5 5 5
