15
20
5 5 5 5 5 5 5 5 5 5 5 5 5 5 5 5 5 5 5 5 
5 0 0 0 0 0 0 0 0 0 0 0 0 0 0 0 0 0 0 5 
5 0 0 0 0 0 0 0 0 0 0 0 0 0 0 0 0 0 0 5 
5 0 0 0 0 0 0 0 0 0 0 0 0 0 0 0 0 0 0 5 
5 0 0 0 0 0 0 3 3 3 3 3 3 3 3 3 3 3 3 5 
5 0 0 0 0 0 0 0 0 0 0 0 0 0 0 0 0 0 0 5 
5 0 0 0 0 0 0 0 0 0 0 0 0 0 0 0 0 0 0 5 
5 0 0 0 0 0 0 0 0 0 0 0 0 0 0 0 0 0 0 5 
5 0 0 0 0 0 0 0 0 0 0 0 0 0 0 0 0 0 0 5 
5 0 0 0 0 0 0 0 0 0 16 0 0 0 0 0 0 0 0 5 
5 0 0 0 0 16 0 0 0 14 14 14 14 0 0 16 0 0 0 5 
5 0 0 0 13 6 6 6 6 0 0 0 0 10 10 10 0 0 0 5 
5 0 0 0 0 0 16 0 0 0 0 16 0 0 0 0 0 0 0 5 
5 15 9 0 0 0 11 0 0 0 0 7 0 0 0 13 0 0 0 5 
5 5 5 5 5 5 5 5 5 5 5 5 5 5 5 5 5 5 5 5 
