15
20
5 5 5 5 5 5 5 5 5 5 5 5 5 5 5 5 5 5 5 5 
5 5 5 5 5 5 5 5 5 5 5 5 5 5 5 5 5 5 5 5 
5 5 0 0 0 0 0 0 0 0 0 0 0 0 0 0 0 0 5 5 
5 5 0 0 0 0 0 0 0 0 0 0 0 0 0 0 0 0 5 5 
5 5 0 0 0 0 0 0 0 0 0 0 0 0 0 0 0 0 5 5 
5 5 0 0 0 0 0 0 0 0 0 0 0 0 0 0 0 0 5 5 
5 5 0 0 0 0 0 0 0 0 0 0 0 0 0 0 0 0 5 5 
5 5 0 0 0 3 3 3 0 0 0 0 0 0 0 0 0 0 5 5 
5 5 15 0 5 0 0 0 5 14 14 14 0 0 0 0 9 0 5 5 
5 5 5 5 5 7 7 7 5 13 13 13 5 5 5 5 5 0 5 5 
5 5 0 0 0 0 0 0 0 0 0 0 0 0 0 0 0 0 5 5 
5 5 0 0 0 0 0 0 0 0 0 0 0 0 0 0 0 0 5 5 
5 5 0 0 0 0 0 0 0 0 0 0 0 0 0 0 0 0 5 5 
5 5 5 5 5 5 5 5 5 5 5 5 5 5 5 5 5 5 5 5 
5 5 5 5 5 5 5 5 5 5 5 5 5 5 5 5 5 5 5 5 
