15
15
5 5 5 5 5 5 5 5 5 5 5 5 5 5 5 
5 0 3 3 3 0 0 0 0 0 0 0 0 0 5 
5 0 5 5 5 5 5 0 0 0 0 0 0 0 5 
5 0 0 0 0 0 0 5 0 0 0 0 5 5 5 
5 0 0 0 0 0 0 0 5 0 0 5 0 0 5 
5 5 5 5 5 0 0 0 0 0 0 0 0 0 5 
5 0 0 0 0 0 0 0 0 0 5 0 0 0 5 
5 0 0 0 0 0 0 0 5 0 0 0 0 0 5 
5 0 0 0 0 0 5 0 0 0 0 0 0 0 5 
5 0 0 0 0 0 0 0 0 0 0 0 0 0 5 
5 0 0 0 5 5 5 5 0 0 0 9 0 0 5 
5 0 0 0 5 0 0 5 0 0 0 0 0 0 5 
5 0 0 5 5 0 0 5 5 5 5 5 0 0 5 
5 15 5 5 5 0 0 0 0 0 0 5 0 0 5 
5 5 5 5 5 5 5 5 5 5 5 5 5 5 5 
