15
20
5 5 5 5 5 5 5 5 5 5 5 5 5 5 5 5 5 5 5 5 
5 0 0 0 0 0 0 0 0 0 0 0 0 0 0 0 0 0 0 5 
5 0 0 0 0 0 0 0 0 0 0 0 0 0 0 0 0 0 0 5 
5 0 0 0 0 0 0 0 0 0 0 0 0 0 0 0 0 0 0 5 
5 0 0 0 0 0 3 3 3 0 0 0 0 0 0 0 0 0 0 5 
5 0 0 0 0 0 0 0 3 3 3 3 0 0 0 0 0 0 0 5 
5 0 0 0 0 0 0 0 0 0 0 12 0 0 0 0 0 0 0 5 
5 0 0 0 0 0 0 0 0 0 0 0 0 0 0 0 0 0 0 5 
5 0 0 0 0 0 0 0 0 0 0 0 0 0 0 9 0 0 0 5 
5 0 0 0 0 0 0 0 0 0 0 0 0 0 0 0 0 0 0 5 
5 0 0 0 0 0 0 0 0 0 0 0 0 0 12 0 12 0 0 5 
5 0 0 0 0 0 0 0 0 0 0 12 0 0 0 0 0 0 0 5 
5 0 0 0 0 0 0 12 0 0 0 0 0 0 12 0 12 0 0 5 
5 0 0 15 5 5 5 5 5 5 0 0 0 0 0 0 0 0 0 5 
5 5 5 5 5 5 5 5 5 5 5 5 5 5 5 5 5 5 5 5 
