15
20
5 5 5 5 5 5 5 5 5 5 5 5 5 5 5 5 5 5 5 5 
5 0 0 16 0 0 0 0 0 0 0 0 0 0 0 0 0 0 0 5 
5 3 0 0 0 0 0 0 0 0 0 0 0 0 0 0 0 0 0 5 
5 6 6 6 6 3 0 0 0 0 0 0 0 3 0 6 6 6 0 5 
5 0 0 0 6 6 6 0 0 0 0 0 0 6 6 6 0 0 0 5 
5 0 0 0 6 0 0 0 0 0 0 0 0 0 0 0 0 0 0 5 
5 0 0 0 0 0 0 0 0 0 0 0 0 0 0 0 0 0 0 5 
5 8 0 0 0 0 0 0 0 0 0 0 0 0 0 0 0 0 0 5 
5 5 14 14 13 10 14 14 14 14 14 14 5 0 0 0 0 0 0 5 
5 0 0 0 0 0 0 0 0 0 0 0 0 0 16 0 0 0 0 5 
5 0 0 0 0 0 0 0 0 0 0 0 0 0 5 5 0 0 0 5 
5 0 0 0 0 0 0 16 0 0 0 0 0 0 5 5 5 9 0 5 
5 15 5 11 0 0 0 6 0 5 0 0 0 0 5 5 5 5 0 5 
5 0 5 7 7 7 6 6 6 6 6 13 6 6 6 5 5 5 5 5 
5 5 5 5 5 5 5 5 5 5 5 5 5 5 5 5 5 5 5 5 
